0, 500, 700, 1, 2, 3, 4, 0
1, 500, 900, -1, 0, -1, -1, 0
2, 500, 500, 0, -1, -1, -1, 0
3, 300, 700, -1, -1, -1, 0, 0
4, 700, 700, -1, -1, 0, -1, 0